ebad_cyc.c	pl_Msg, XZEXC_MSG_REVEIL
ebaf_cyc.c	pl_Msg, XZEXC_MSG_REVEIL
ecfe_cyc.c	pl_Msg, XZEXC_MSG_REVEIL
edai_cyc.c	pl_Msg, XZEXC_MSG_REVEIL
edai_tra.c	Donnees trame
egab_cyc.c	pl_Msg, XZEXC_MSG_REVEIL
egab_tra.c	Donnees trame
eimi_pro.c	XZSM_07								
eimu_cyc.c	pl_Msg, XZEXC_MSG_REVEIL
elmi_pro.c	XZSM_07
enav_cyc.c	pl_Msg, XZEXC_MSG_REVEIL
enic_tra.c	pl_Msg, XZEXC_MSG_REVEIL
eniw_tra.c	pl_Msg, XZEXC_MSG_REVEIL
enix_tra.c	pl_Msg, XZEXC_MSG_REVEIL
epal_cyc.c	pl_Msg, XZEXC_MSG_REVEIL
epma_cyc.c	pl_Msg, XZEXC_MSG_REVEIL
epmv_cyc.	pl_Msg, XZEXC_MSG_REVEIL
eprv_cyc.c	pl_Msg, XZEXC_MSG_REVEIL
eqtx_cyc.c	pl_Msg, XZEXC_MSG_REVEIL
eqtx_don.c	XZSM_07
eqtx_tra.c	XZSM_07
erau_cyc.c	pl_Msg, XZEXC_MSG_REVEIL
erdt_cal.c	erdt_tra.c / vl_Horodate
erdt_cfg.c	time ( &vl_time ) et erdt_tra.c / vl_Horodate et XZSM_07
erdt_cyc.c	pl_Msg, XZEXC_MSG_REVEIL
erdt_don.c	TipcMsgRead
erdt_renv.c	XZSM_07
erdt_tra.c	!time(&vl_time)
ereg_cfg.c	asql_date_Sybase2Ux
ereg_detection.c	XZSM_07
ereg_dir.c	TipcMsgRead
ereg_util.c	XZSM_07
esag_cyc.c	pl_Msg, XZEXC_MSG_REVEIL
esat_cmd.c	obsolete
esat_cyc.c	obsolete
esx0_cyc.c	pl_Msg, XZEXC_MSG_REVEIL et XZSM_07
etdp_cyc.c	XZSM07 et time ( &vl_time ) et pl_Msg, XZEXC_MSG_REVEIL
etdp_don.c	XZSM_07 
etim_trt.c	XZSM_07
ex_mala.c	XZSM_07
ex_mcom.c	XZSM_07
ex_mlcr.c	XZSM_07
